111111111111111111111
1000C0000000000000001
100000000000000000001
100000000000000001001
100000000000000001001
1000111111110C0111C01
1000P0000000000000001
100000000000000001001
100000000000000001001
1000000000000G0001001
100000G000C0000001001
1000000000000E0001001
111111111111111111111